############### ###############
#{************# #*************#
#*#####0#####*# #*#####0#####*#
#*#   #*#   #*# #*#   #*#   #*#
#*#####*#####*###*#####*#####*#
#*****************************#
#*#####*###*#######*###*#####*#
#*******# #***# #***# #*******#
#######*# ###*# #*### #*#######
      #*#   #*###*#   #*#
      #*# ###*****### #*#
      #*# #*********# #*#
#######*###*##   ##*###*#######
************#     #************
#######*###*# 666 #*###*#######
      #*# #*#######*# #*#
      #*# #*********# #*#
      #*# ###*###*### #*#
      #*#   #*# #*#   #*#
#######*# ###*# #*### #*#######
#*******# #***# #***# #*******#
#*#####*###*#######*###*#####*#
#***# #*****************#   #*#
###*# #*###*#####*#####*#   #*#
###*###0# #*#####*#   #0#####*#
#*******# #*******#   #*******#
######### #########   #########